1 3 1 1 1 1 1 1 1 1 1 1 1 1 1 1  
2 3 3 3 6 3 3 6 3 3 6 3 3 0 3 2  
2 3 5 0 5 5 3 5 0 5 5 3 5 6 3 2 
2 0 3 3 0 3 3 3 3 3 3 3 3 5 3 2  
2 3 5 3 6 3 6 3 5 3 5 0 5 3 0 2  
2 3 3 0 3 3 3 4 4 3 0 3 3 3 6 2  
2 6 5 3 5 3 5 4 4 0 5 3 5 6 3 2  
2 3 3 0 6 0 6 3 5 3 3 0 5 3 0 2  
2 0 5 3 3 3 0 3 3 3 6 3 3 6 3 2  
2 3 6 3 5 6 3 5 3 5 3 5 0 3 3 2  
2 3 3 3 5 3 3 3 3 6 3 3 3 5 3 2 
1 1 1 1 1 1 1 1 1 1 1 1 1 1 3 1  